==================================
|********|********|********|*****|
|==  ====|        |  ======|     |
|****|***|********|        |*****|
|==  |== |====  ==|  ======|     |
|****|***|        |********|*****|
|********|********|********|*****|