====================================
|**********************************|
|==== ===  =============  =========|
|*******|  |                       |
|****|**|  |=====   ====   ========|
|==== *=|  |           |  |        |
|*******|  |           |  |=====   |
