====================================
=                                  =
=**********************************=
=                                  =
===== ===  =============  ==========
=                                  =
=*******=  =                       =
=                                  =
=****=**=  ======   ====   =========
=                                  =
===== *==  =           =  =        =
=                                  =
=*******=  =           =  ======   =