==================================
|**********|**********|**********|
|==  ====  |          |  ========|
|****|**** |**********|          |
|==  |==   |====  ====|  ========|
|****|**** |          |**********|
|**********|**********|**********|